create	pro_main	pro_occ	use	interested	total
Games	85	40	116	26	267
Web sites (front end)	56	24	44	15	139
Web sites (back end)	42	19	33	12	106
Desktop applications	46	32	63	20	161
Mobile applications	67	31	69	27	194
Software libraries / frameworks	55	24	51	5	135
Hardware stuffs	5	4	7	2	18
Art	10	9	15	3	37
I'm not sure yet.	1	0	5	2	8
Others	9	2	4	2	17
