os_linux	pro_main	pro_occ	use	interested	total
Ubuntu	52	24	50	21	147
Debian	14	8	19	3	44
Fedora	4	3	6	0	13
openSUSE	2	1	7	3	13
Gentoo	0	0	4	0	4
Mandriva	0	0	0	0	0
Red Hat	3	0	0	0	3
Oracle	0	0	0	0	0
Solaris	1	0	0	0	1
Turbolinux	0	0	0	0	0
Arch Linux	8	5	15	4	32
FreeBSD	1	0	2	2	5
OpenBSD	0	0	0	1	1
NetBSD	0	0	0	0	0
Linux Mint	4	4	7	2	17
elementary OS	1	0	2	0	3
Others	4	0	5	1	10
