target	pro_main	pro_occ	use	interested	total
JS	102	50	92	28	272
C++	82	44	110	30	266
Flash (SWF)	68	28	70	13	179
Neko	58	22	72	11	163
Java	31	10	33	9	83
PHP	29	16	19	5	69
C#	20	11	27	9	67
AS3 (source code)	10	9	12	6	37
Python	9	4	14	4	31
compiler interpeter (--interp / --run)	11	1	16	0	28
